4 5
10
1 3 2 2 1 1
3 3 1 2 1 1
3 1 1 2 1 1
3 0 1 1 1 1
1 2 2 1 1 1
2 1 1 1 1 1
1 1 1 1 1 1
0 0 1 1 1 1
0 1 1 2 1 1
0 3 1 2 1 1
