6 6
13
2 3 2 1 1 0
0 3 1 2 0 1
1 0 1 2 0 1
2 1 1 2 0 1
3 4 1 2 0 1
4 3 1 3 0 1
5 3 1 3 0 1
0 5 3 1 1 0
1 4 2 1 1 0
0 2 2 1 1 0
4 1 2 1 1 0
2 0 2 1 1 0
4 0 2 1 1 0
